





##################################################
|................................................|
|................................................|
|................................................|
|................................................|
|................................................|
|__R_____________________________________________|
|................................................|
|................................................|
|................................................|
|................................................|
|................................................|
|________________________R________________R______|
|................................................|
|................................................|
|................................................|
|................................................|
|................................................|
|________________________________________________|