                             #####################
                             |...................|
                             D..bb..0000.........|
         @                   D..bb..0000.........|
                             D..bb.P...........BB|
                             D..ppttp.........BBB|
#############################______________R_____|
|...............|.........C.........|............|
|.000.......000.D...000.......000...D............|
|........BB.....D...000..bbb..000...D.bbb......B.|
|.......BBBBBB..D...000..bbb..000...D.........BB.|
|.ppp..BBBBBBBB.D........bbb........D.ppp.....BBB|
|__R_____________________________________________|
|..........C...........|.........|...............|
|......................D........b|...............|
|B........bbb......bb..D........b|bbbbb..........|
|BB.......bbb......bb..D........b|bP..b..........|
|BB....pttpppttp...bb..D...ptp.tb|ptttp..........|
|________________________R________________R______|
|................|...........|.........C.........|
|................D...........D...................|
|................D...........D..................b|
|................D.PBB.......D......BB..........b|
|................D.pBBBB.....D...BBBBBB.........p|
|________________________________________________|