                             #####################
                             |...................|
                             |.SSS..0000.........|
                             |.SSS..0000.........|
                             |.SSS.............BB|
                             |.SSS............BBB|
#############################____________________|
|................................................|
|................................................|
|................................................|
|................................................|
|................................................|
|________________________________________________|
|................................................|
|................................................|
|................................................|
|................................................|
|................................................|
|________________________________________________|
|................................................|
|................................................|
|................................................|
|................................................|
|................................................|
|________________________________________________|