                             #####################
                             W...................|
                             D..bb..0000.........|
         @                   D..bb..0000.........|
                             D..bb.P...........BB|
                             D..ppttp.........BBB|
#############################______________R_____|
|...............W.........C.........W............|
|.000.......000.D...000.......000...D............|
|........BB.....D...000..bbb..000...D.bbb......B.|
|.yyy...BBBBBB..D...000..bbb..000...D.........BB.|
|.ppp..BBBBBBBB.D........bbb........D.ppp.....BBB|
|__R_____________________________________________|
|..........C...........W.........W...............|
|......................D........bW...............|
|B........bbb......bb..D........bWbbbbb..........|
|BB.......bbb......bb..D........bWbPyyb..........|
|BB....pttpppttp...bb..D...ptp.tbWptttp..........|
|________________________R________________R______|
|................W...........W.........C.........|
|bb..bbbbbb......D...........D...................|
|bb..yyGyyy......D...........D..................b|
|bb..yyyyyy......D.PBB.......D......BB..........b|
|bb..pttttp......D.pBBBB.....D...BBBBBB.........p|
|________________________________________________|