                             #####################
                             |...................|
                             |......0000.........|
                             |......0000.........|
                             |.................BB|
                             |................BBB|
#############################____________________|
|....................C...........................|
|................................................|
|................................................|
|................................................|
|................................................|
|________________________________________________|
|.......C..............................C.........|
|................................................|
|................................................|
|................................................|
|................................................|
|________________________________________________|
|................................................|
|................................................|
|................................................|
|................................................|
|................................................|
|________________________________________________|