                             #####################
                             |...................|
                             D......0000.........|
                             D......0000.........|
                             D.................BB|
                             D................BBB|
#############################______________R_____|
|...............|.........C.........|............|
|.000.......000.D...000.......000...D............|
|........BB.....D...000.......000...D............|
|.......BBBBBB..D...000.......000...D............|
|......BBBBBBBB.D...................D............|
|__R_____________________________________________|
|..........C...........|.........W...............|
|......................D.........W...............|
|......................D.........W...............|
|......................D.........W...............|
|......................D.........W...............|
|________________________R________________R______|
|................|...........|.........C.........|
|................D...........D...................|
|................D...........D...................|
|................D...........D...................|
|................D...........D...................|
|________________________________________________|